MMMMMMMMMMMMMMMMM
HHHHHHHHHHHHHHHHH
HHHHHHHHHHHHHHHHH
BBBBBBBBBBBBBBBBB
BBBBBBBBBBBBBBBBB