MMMMMMMMMMMMMMMMM
HHHHMMMMMMMMHHHHH
HHHHHHMMMHHHHHHHH
BBBBBBBBBBBBBBBBB
BBBBBBBBBBBBBBBBB