MMMMMMMMMMMMMMMMM
HHHHMMMMMMMMHHHHH
HHHHHHHHHHHHHHHHH
BBBBBBBBBBBBBBBBB
BBBBBBBBBBBBBBBBB