     BBBBBBB     
MMMMMMMMMMMMMMMMM
HHHHHMMMMMMHHHHHH
HHHHHHMMMHHHHHHHH
HHHHHHHHHHHHHHHHH
BBBBBBBBBBBBBBBBB
     BBBBBBB     