    HBBBBBBBH    
MMMMMMMMMMMMMMMMM
HHHHHMMMMMMHHHHHH
HHHHHMMMMMMHHHHHH
HHHHHHMMMHHHHHHHH
BBBBBBBBBBBBBBBBB
BBBBBBBBBBBBBBBBB