MMMMMMMMMMMMMMMMM
HHHMMMMMMMMMMHHHH
HHHHHMMMMMMHHHHHH
TTTTTTTTTTTTTTTTT
BBBBBBBBBBBBBBBBB